NO src/textures/north.xpm
SO src/textures/south.xpm
WE src/textures/west.xpm
EA src/textures/east.xpm

F 200,200,200
C 000,000,000    
    
11111111111111111111111111111111111111111
10000000000000000000000000000000000000001
10000000000000000000000000000000000000001
10000000000000000000000000000000000000001
10000000000000111110000011111001111000001
10000000000001111100000011110001111000001
10000000000011111000000011100001111000001
10000000000111110000000011000011111000001
10000000001111100000000010000111111000001
10000000011111000000000000001111110000001
10000000111110000000000000011111100000001
10000001111100000000000000111111000000001
10000011111000000000000001111110000000001
10000111111111111111100011111100001000001
10000111111111111111100011111000011000001
10000111111111111111100011110000111000001
10000111111111111111100011110001111000001
10000000000000000111100011110011111000001
10000000000000000111100000000000000000001
10000000000000000111100010000000000000001
10000000000000000111100011101110101000001
10000000000000000111100010101000111000001
1000000000W000000111100011101110101000001
10000000000000000000000000000000000000001
10000000000000000000000000000000000000001
11111111111111111111111111111111111111111