NO src/textures/north.xpm
SO src/textures/south.xpm
WE src/textures/west.xpm
EA src/textures/east.xpm

F 200,200,200
C 000,000,000    
    
11111111111111111111111111111111111111111
10000000000000000000000000000000000000001
10000000000000000000000000000000000000001
10000000000000000000000000000000000000001
10000000000000111110000011111001111000001
10000000000001   10000001  10001  1000001
1000000000001   100000001 100001  1000001
100000000001   1000000001100001   1000001
10000000001   1000000000100001    1000001
1000000001   1000000000000001    10000001
100000001   1000000000000001    100000001
10000001   1000000000000001    1000000001
1000001   1000000000000001    10000000001
100001    111111111110001    100001000001
100001              10001   1000011000001
100001              10001  100001 1000001
100001111111111111  10001  10001  1000001
100000000000000001  100011110011111000001
100000000000000001  100000000000000000001
100000000000000001  100010000000000000001
100000000000000001  100011101110101000001
100000000000000001  100010101000111000001
1000000000W000000111100011101110101000001
10000000000000000000000000000000000000001
10000000000000000000000000000000000000001
11111111111111111111111111111111111111111