NO src/textures/north.xpm
SO src/textures/south.xpm
WE src/textures/west.xpm
EA src/textures/east.xpm

F 200,200,200
C 000,000,000

11111111111111111111111111111111111111111
10000000001111100000000111100000000000001
10111111001000101111110000101111111111001
10000001001110100000010000100000000001001
10111001000111101111110000101111111001001
10001001110000100000001110100000001001001
10111000011110111110111001111101111001001
10000000010000100000100000000001000001001
10111111010111101110101110111101011111001
10000001010000100000100000000101000000001
11111001011111111110101111110101111111001
10000001000000000010101000010000000001001
10111111101111111011101111110111111101001
10000000001000001000000000010000000101001
10111111111011101111111110111111110111001
10000000000010101000000100000000010000001
10111111111010101111110111111110101111101
10000000001000101000000100000010101000001
10111111011110101111111110111010101111101
100000N0010000001000000000001000001000001
11111111111111111111111111111111111111111