NO src/textures/north.xpm
SO src/textures/south.xpm
WE src/textures/west.xpm
EA src/textures/east.xpm

F 200,200,200
C 000,000,000

11111111111111111111
10000000000111000001
10111111000000001111
10000001001110100001
10111101000111111011
10010011000000010001
10111000011110111101
10000000010000100001
10111111010111101111
10010001010000100001
10011001011110101111
10010001000010100001
11101111101110111111
10000000001000000001
10111111111011101111
10000000000010100001
11111011111110001001
10000000000000100101
10111111011110101001
100000N0010000000001
11111111111111111111

