NO src/textures/north.xpm
SO src/textures/south.xpm
WE src/textures/west.xpm
EA src/textures/east.xpm


F 101,67,33
C 000,100,200

111111111111111
100000000000001
101000000010001
100000000000001
100000000000001
1000000S0000001
100000000000001
100010000010001
100000000000001
111111111111111