NO src/textures/north.xpm
SO src/textures/south.xpm
WE src/textures/west.xpm
EA src/textures/east.xpm

F 101,67,33
C 000,100,200

111111111111111
100000000000001
101110000010001
101 10000000001
101110000000001
1000000N0001001
10000000001 101
100010000001001
100000000000001
111111111111111